##############
#       . #  #
#       # .  #
##.###### #  #
#    ##*# #  #
# m     # ####
######### ####
#     ##    ##
#*    ## ##.##
# m   .. #   #
#     ## #   #
######## #   #
#@       # * #
##############
